OOOOOOOOOOOOOOO
O IO    O     O
O  . OO       O
O  O O   X    O
O  OOOOOO,OOOOO
O  .IO       EU
O  OOOOOO,OOOOO
O  O         IO
O  O OOOOOOOOOO
O  .         IO
OOOOOOOOOOOOOOO