OOOOOOOOOOOOOOO
O  O    O     O
O  . OO       O
O  O O   X    O
O  OOOOOO,OOOOO
O  O O       EU
O  OOOOOO,OOOOO
O  O          O
O  O OOOOOOOOOO
O  .          O
OOOOOOOOOOOOOOO